VVVVVVVVVRVBRBV
BVVVVRBVVBRRVRB
VBBRVRBVRRBRRRR
BRBVBRBBVVRRVRV
RVBVVVVRRBRRRBV
RVVVBBRBVVBVVRB
BRBRBBBRBVRVRRV
VRRVVBBVVBBRVVV
BVRRVVBRVRRRBVV
BBRBBBBRVVRRVRB